3131414242
4        4
3   14   1
4   1    1
1       31
24234    4
1       31
2  5  5  1
3  5  5  4
1214551311